##############                                     
##*#         #
#  #         #
## #         #
#  #         #
#  #         #
#         #
#            #
#            #
#           *#
#            #
##############







