Shortest way is 12
##############
##O#         #
# *#*O       #
##*#*#       #
# *#*        #
# *#*        #
# ***        #
#            #
#            #
#            #
#            #
##############
