##############                                     
##*#         #
#  # *       #
## # #       #
#  #         #
#  #         #
#            #
#            #
#            #
#            #
#            #
##############







