##############
##*#         #
#  #         #
## #         #
#  #         #
#  #         #
## #         #
#            #
#         *  #
#            #
#            #
##############