###################                                     
##*# *            #
#  ##### ######## #
## #    ####      #
#  #         ######
#  #              #
#   #########     #
#   #             #
#    #            #
#     #            
#      #          #
#       #         #
#        #        #
#         #    ####
#######  #   ##   #
#        #   ##   #
#        #      ###
#        ######   #
#                 #
###################






