##############                                     
##*#        *#
#  # #########
## # #       #
#  #         #
#  #         #
#            #
#            #
#            #
#            #
#            #
##############







