Shortest way is 16
##############
##O#**O      #
# *#*        #
##*#*        #
# *#*        #
# *#*        #
##*#*        #
# ***        #
#            #
#            #
#            #
##############
