##############                                     
##*#  *      #
#  #         #
## #         #
#  #         #
#  #         #
## #         #
#            #
#            #
#            #
#            #
##############



