################################################################################                                     
##*#*                                                                          #
#  ##########                                                                  #
## #                                                                           #
#  #    #######                                                                #
#  #                                                                           #
#   ###########                                                                #
#   #                                                                          #
#    #                                                                         #
#     #                                                                        #
#                                                                              #
################################################################################






