Shortest way is 19
##############
##O#         #
# *# #########
##*# #       #
# *#         #
# *#         #
# *          #
# *          #
# *          #
# *          #
# **********O#
##############
