##############
##*#         #
#  #         #
## #         #
#  #         # 
#  #         #
## #         #
#            #
#  ##       *#
############## 
 