##############                                     
##*#*        #
#  #         #
## #         #
#  #         #
#  #         #
## #         #
#            #
#            #
#            #
#            #
##############







