##############                                     
##*#         #
#  # #########
## # #       #
#  #         #
#  #         #
#            #
#            #
#            #
#            #
#           *#
##############







