Shortest way is 20
##############
##O#********O#
# *#*#########
##*#*#       #
# *#*        #
# *#*        #
# ***        #
#            #
#            #
#            #
#            #
##############
